///////////////////
/.F....../......../
/.//.///././//.//./
/........P......../
/.//././////././/./
/..../.../.../..../
////.///././//.////
////./......././///
////././/G//././///
...F.../GGG/...F...
////././////././///
////./......././///
////.///././//.////
/..../.../.../..../
/.//././////././/./
/.F.............../
/.//.///././//.//./
/......../...F..../
///////////////////